                  4                 4           4             4
                       4                              4
                                        4
33333333333333333333333333333333333333333333333333333333333333333333333333333333333333333333333333333333
30000000000000000000000000000000000000000000000000000000000000000000000000000000000000000000000000000003
30000000000000000000000000000000000000000000000000000000000000000000000000000000000000000000000000000003
30000000000000000000000000000000000000000000000000000000000000000000000000000000000000000000000000000003
30000000000000000000000000000000000000000000000000000000000000000000000000000000000000000000000000000003
30000000000000000000000000000000000000000000000000000000000000000000000000000000000000000000000000000003
30000000000000000000000000000000000000000000000000000000000000000000000000000000000000000000000000000003
30000000000000000000000000000000000000000000000000000000000000000000000000000000000000000000000000000003
30000000000000000000000000000000000000000000000000000000000000000000000000000000000000000000000000000003
30000000000000000000000000050000000000000000000000000000000500000000000000000000000000000000000000000003
30000000000000000000000000000000000000000000000000000000000000000000000000000000000000000000000000000003
30000000000000000000000000000000000000000000000000000000000000000000000000000000000000000000000000000003
30000000000000000000000000011111000000000000000000000000000000000000000000000000000000000000000000000003
30000000000000000000000000022000000000000000000000000000000000000000000000000000000000000000000000000003
30000000000010000000000000000000000000000000000000000000000000000000000000000000000000000000000000000003
30000000111120000000000000000000000000000000000000000000000000000000000000000000000000000000000000000003
30000000002230000000000000000000000000000000000000000000000000000000000000000000000000000000000000000003
30000000003330000000000000000000000000000000000000000000000000000000000000000000000000000000000000000003
30000000003330000000000000000000000000000000000000000000000000000000000000000000000000000000000000000003
30000000003330000000000000000000000000000000000000000000000000000000000000000000000000000000000000000003
30000000003330000000000000000000000000000000000000000000000000000000000000000000000000000000000000000073
31111111111111111111111111111111111111111111111111111111111111111111111111111111111111111111111111111113
32222222222222222222222222222222222222222222222222222222222222222222222222222222222222222222222222222223
33333333333333333333333333333333333333333333333333333333333333333333333333333333333333333333333333333333
33333333333333333333333333333333333333333333333333333333333333333333333333333333333333333333333333333333
33333333333333333333333333333333333333333333333333333333333333333333333333333333333333333333333333333333
33333333333333333333333333333333333333333333333333333333333333333333333333333333333333333333333333333333
33333333333333333333333333333333333333333333333333333333333333333333333333333333333333333333333333333333
33333333333333333333333333333333333333333333333333333333333333333333333333333333333333333333333333333333
eeeeeeeeeeeeeeeeeeeeeeeeeeeeeeeeeeeeeeeeeeeeeeeeeeeeeeeeeeeeeeeeeeeeeeeeeeeeeeeeeeeeeeeeeeeeeeeeeeeeeeee