                                    4           4             4
                                                      4
33333333333333333333333333333333333333333333333333333333333333333333333333333333333333333333333333333333
30000033000000000000000000000000000000000000000000000000000000000000000000000000000000000000000000000003
30000033000000000000000000000000000000000000000000000000000000000000000000000000000000000000000000000003
30000033000000000000000000000000000000000000000000000000000000000000000000000000000000000000000000000003
30000033000000000000000000000000000000000000000000000000000000000000000000000000000000000000000000000003
30000033000000000000000000000000000000000000000000000000000000000000000000000000000000000000000000000003
30000033000000000000000000000000000000000000000000000000000000000000000000000000000000000000000000000003
30000033000000000000000000000000000000000000000000000000000000000000000000000000000000000000000000000003
30000033000000000000000000000000000000000000000000000000000000000000000000000000000000000000000000000003
30000033000000000000000000000000000000000000000000000000000500000000000000000000000000000000000000000003
30000000000000000000000000000000000000000000000000000000000000000000000000000000000000000000000000000003
30000000000000000000000000000000000000000000000000000000000000000000000000000000000000000000000000000003
30000033000000000000000000000000000000000000000000000000000000000000000000000000000000000000000000000003
30000033000000000000000000000000000000000000000000000000000000000000000000000000000000000000000000000003
30000033000000000000000000000000000000000000000000000000000000000000000000000000000000000000000000000003
30000033000000000000000000000000000000000000000000000000000000000000000000000000000000000000000000000003
3000u033000000000000000000000000000000000000000000000000000000000000000000000000000000000000000000000003
30000033000000000000000000000000000000000000000000000000000000000000000000000000000000000000000000000003
30000033000000000000000000000000000000000000000000000000000000000000000000000000000000000000000000000003
30000033000000000000000000000000000000000000000000000000000000000000000000000000000000000000000000000003
30000033000000000000000000000000000000000000000000000000000000000000000000000000000000000000600000000073
31111133111111111111111111111111111111111111111111111111111111111111111111111111111111111111111111111113
32222233222222222222222222222222222222222222222222222222222222222222222222222222222222222222222222222223
3m333333333333333333333m333333333333333333333m33333333333333333333333333333333333333m3333333333333333333
3m333333333333333333333m33333333333333333333333m33333333333333333333333333333333333333333333333333333333
3m333333333333333333333333333333333333333333333333333333333333333333333333333333333333333333333333333333
3m333333333333333333333333333333333333333333333333333333333333333333333333333333333333333333333333333333
33333333333333333333333333333333333333333333333333333333333333333333333333333333333333333333333333333333
33333333333333333333333333333333333333333333333333333333333333333333333333333333333333333333333333333333
eeeeeeeeeeeeeeeeeeeeeeeeeeeeeeeeeeeeeeeeeeeeeeeeeee33333333333333333333333333333333333333333333333333333