                4           4        4           4          4       4                 4        4                4
                            4                                           4         4       4          4
                     4                    4           4                     4                              4
bbbbbbbbbbbbbbbbbbbbbbbbbbbbbbbbbbbbbbbbbbbbbbbbbbbbbbbbbbbbbbbbbbbbbbbbbbbbbbbbbbbbbbbbbbbbbbbbbbbbbbbbbbbbbbbbbbbbbb
bb0000000000000000000000000000000000000000000000000000000000000000000000000000000000000000000000000000000000000000000b
bb0000000000000000000000000000000000000000000000000000000000000000000000000000000000000000000000000000000000000000000b
bb0000000000000000000000000000000000000000000000000000000000000000000000000000000000000000000000000000000000000000000b
bb0000000000000000000000000000000000000000000000000000000000000000000000000000000000000000000000000000000000000000000b
bb0000000000000000000000005000000000000000000000000000000000000000000000000000005000000000000000000000000000000000000b
bb0000000000000000000000000000000000000000000000000000000000000000000000000000000000000000000000000000000000000000000b
bb0000000000000000000000000000000000000000000000000000000000000000000000000000000000000000000000000000000000000000000b
bb0000000000000000000000000000000000000000000000000000000000000000000000000000000000000000000000000000000000000000000b
bb0000000000000000000000000000000000000000000000000000000000000000000000000000000000000000000000000000000000000000000b
bb0000000000000000011111110000000000000000000000000500000000000000000000000000000000000000000000000000050000000000000b
bb0000000000000000002222220000000000000000000000000000000000000000000000000000000000000000000000000111100000000000070b
bb0000000000000000000000030000000000000000000000000000000000000000000000000000000000000000000000000233200000000011111b
bb1111100000000000000000000000000000000000000000000000000000000000000011110000000000000000000000000033000000000000022b
bb0000000000000000000000000000000000000500000000000000000000000000000002222000000000000000000000000000000000000000003b
bb0000000000000000000000000000000000000000000000000000000000000000000003300000000000000000000000000000000000000000000b
bb0000000000000000000000000000000000000000000000000000000000000000000000000000000000000000000000000000000000000000000b
bb0000000000000000000000000000000000000000000000000000000000000000000000000000000000000000000000000000000000000000000b
bb0000000000000000000000000000000000000000000000000000000000000000000000000000000000000000000000000000000000060000000b
bb1111111111111111111111111111111111111111111111111111111111111111111111111111111111111111111111111111111111111111111b
bb2222222222222222222222222222222222222222222222222222222222222222222222222222222222222222222222222222222222222222222b
bb3333333333333333333333333333333333333333333333333333333333333333333333333333333333333333333333333333333333333333333b
bb3333333333333333333333333333333333333333333333333333333333333333333333333333333333333333333333333333333333333333333b
bb3333333333333333333333333333333333333333333333333333333333333333333333333333333333333333333333333333333333333333333b
bb3333333333333333333333333333333333333333333333333333333333333333333333333333333333333333333333333333333333333333333b
bb3333333333333333333333333333333333333333333333333333333333333333333333333333333333333333333333333333333333333333333b
bb3333333333333333333333333333333333333333333333333333333333333333333333333333333333333333333333333333333333333333333b
eeeeeeeeeeeeeeeeeeeeeeeeeeeeeeeeeeeeeeeeeeeeeeeeeeeeeeeeeeeeeeeeeeeeeeeeeeeeeeeeeeeeeeeeeeeeeeeeeeeeeeeeeeeeeeeeeeeeee