                  4           4        4           4             4                      4
                      4          4                      4             4                       4
                                          4                  4                   4
bbbbbbbbbbbbbbbbbbbbbbbbbbbbbbbbbbbbbbbbbbbbbbbbbbbbbbbbbbbbbbbbbbbbbbbbbbbbbbbbbbbbbbbbbbbbbbbbbbbbbbbb
b000000000000000000000000000000000000000000000000000000000000000000000000000000000000000000000000000000b
b000000000000000000000000000000000000000000000000000000000000000000000000000000000000000000000000000000b
b000000000000000000000000000000000000000000000000000000000000000000000000000000000000000000000000000000b
b000000000000000000000000000000000000000000000000000000000000000000000000000000000000000000000000000000b
b000000000000000000000000000000000000000000000000000000000000000000000000000000000000000000000000000000b
b000000000000000000000000000000000000000000000000000000000000000000000000000000000000000000000000000000b
b000000000000000000000000000000000000000000000000000000000000000000000000000000000000000000000000000000b
b000000000000000000000000000000000000000000000000000000000000000000000000000000000000000000000000000000b
b000000000000000000000000005000000000000000000000000000000050000000000000000000000000000000000000000000b
b000000000000000000000000000000000000000000000000000000001111100000000000000000000000000000000000000000b
b000000000000000000000000000000000000000000000000000000112222200000000000000000000000000000000000000000b
b000000000000000000000000000000000000000000000000000000000000000000000000000000000000000000000000000000b
b000000000000000000000000000000000000000000005000000000000000000000000000005000000000000000000000000000b
b000000000011000000000000000000000000000000000000000000000000000000000000000000000000000000000000000000b
b000000011122000000000000000000000000000000000000000000000000000000000000000000000001111100000000000000b
b000000000033000000000000000000000000000000000000000000000000000000000000000000000002222200000000000000b
b000000000000000000000000000000000000000000000000000000000000000000000000000000000003300000000000000000b
b000000000000000000000000001110000000000000000000000000000000000000000000000000000000000000000000000000b
b000000000000000000000001112220000000000000000000000000000000000000000000000000000000000000000000000000b
b000000000000000000001112223330000000000000000000000000000000000000000000000000000000000000000060000007b
b111111111111111111112223333331111111111111111111111111111111111111111111111111111111111111111111111111b
b222222222222222222233333333332222222222222222222222222222222222222222222222222222222222222222222222222b
b333333333333333333333333333333333333333333333333333333333333333333333333333333333333333333333333333333b
b333333333333333333333333333333333333333333333333333333333333333333333333333333333333333333333333333333b
b333333333333333333333333333333333333333333333333333333333333333333333333333333333333333333333333333333b
b333333333333333333333333333333333333333333333333333333333333333333333333333333333333333333333333333333b
b333333333333333333333333333333333333333333333333333333333333333333333333333333333333333333333333333333b
b333333333333333333333333333333333333333333333333333333333333333333333333333333333333333333333333333333b
eeeeeeeeeeeeeeeeeeeeeeeeeeeeeeeeeeeeeeeeeeeeeeeeeeeeeeeeeeeeeeeeeeeeeeeeeeeeeeeeeeeeeeeeeeeeeeeeeeeeeeee