                  4                 4           4             4                      4
                       4                              4             4                       4
                                        4                                     4
bbbbbbbbbbbbbbbbbbbbbbbbbbbbbbbbbbbbbbbbbbbbbbbbbbbbbbbbbbbbbbbbbbbbbbbbbbbbbbbbbbbbbbbbbbbbbbbbbbbbbbbb
b000000000000000000000000000000000000000000000000000000000000000000000000000000000000000000000000000000b
b000000000000000000000000000000000000000000000000000000000000000000000000000000000000000000000000000000b
b000000000000000000000000000000000000000000000000000000000000000000000000000000000000000000000000000000b
b000000000000000000000000000000000000000000000000000000000000000000000000000000000000000000000000000000b
b000000000000000000000000000000000000000000000000000000000000000000000000000000000000000000000000000000b
b000000000000000000000000000000000000000000000000000000000000000000000000000000000000000000000000000000b
b000000000000000000000000000000000000000000000000000000000000000000000000000000000000000000000000000000b
b000000000000000000000000000000000000000000000000000000000000000000000000000000000000000000000000000000b
b000000000000000000000000005000000000000000000000000000000050000000000000000000000000000000000000000000b
b000000000000000000000000000000000000000000000000000000000000000000000000000000000000000000000000000000b
b000000000000000000000000000000000000000000000000000000000000000000000000000000000000000000000000000000b
b000000000000000000000000001111100000000000000000000000000000000000000000000000000000000000000000000000b
b000000000000000000000000002200000000000000000000000000000000000000000000005000000000000000000000000000b
b000000000001000000000000000000000000000000000000000000000000000000000000000000000000000000000000000000b
b000000011112000000000000000000000000000000000000000000000000000000000000000000000001111100000000000000b
b000000000223000000000000000000000000000000000000000000000000000000000000000000000002000200000000000000b
b000000000333000000000000000000000000000000000000000000000000000000000000000000000000000000000000000000b
b000000000333000000000000000000000000000000000000000000000000000000000000000000000000000000000000000000b
b000000000333000000000000000000000000000000000000000000000000000000000000000000000000000000000000000000b
b000000000333000000000000000000000000000000000000000000000000000000000000000000000000000000000060000007b
b111111111111111111111111111111111111111111111111111111111111111111111111111111111111111111111111111111b
b222222222222222222222222222222222222222222222222222222222222222222222222222222222222222222222222222222b
b333333333333333333333333333333333333333333333333333333333333333333333333333333333333333333333333333333b
b333333333333333333333333333333333333333333333333333333333333333333333333333333333333333333333333333333b
b333333333333333333333333333333333333333333333333333333333333333333333333333333333333333333333333333333b
b333333333333333333333333333333333333333333333333333333333333333333333333333333333333333333333333333333b
b333333333333333333333333333333333333333333333333333333333333333333333333333333333333333333333333333333b
b333333333333333333333333333333333333333333333333333333333333333333333333333333333333333333333333333333b
eeeeeeeeeeeeeeeeeeeeeeeeeeeeeeeeeeeeeeeeeeeeeeeeeeeeeeeeeeeeeeeeeeeeeeeeeeeeeeeeeeeeeeeeeeeeeeeeeeeeeeee