                                    4           4             4
                                                      4
bbbbbbbbbbbbbbbbbbbbbbbbbbbbbbbbbbbbbbbbbbbbbbbbbbbbbbbbbbbbbbbbbbbbbbbbbbbbbbbbbbbbbbbbbbbbbbbbbbbbbbbb
b000000000000000000000000000000000000000000000000000000000000000000000000000000000000000000000000000000b
b000000000000000000000000000000000000000000000000000000000000000000000000000000000000000000000000000000b
b000000000000000000000000000000000000000000000000000000000000000000000000000000000000000000000000000000b
b000000000000000000000000000000000000000000000000000000000000000000000000000000000000000000000000000000b
b000000000000000000000000000000000000000000000000000000000000000000000000000000000000000000000000000000b
b000000000000000000000000000000000000000000000000000000000000000000000000000000000000000000000000000000b
b000000000000000000000000000000000000000000000000000000000000000000000000000000000000000000000000000000b
b000000000000000000000000000000000000000000000000000000000000000000000000000000000000000000000000000000b
b000000000000000000000000000000000000000000000000000000000050000000000000000000000000000000000000000000b
b000000000000000000000000000000000000000000000000000000000000000000000000000000000000000000000000000000b
b000000000000000000000000000000000000000000000000000000000000000000000000000000000000000000000000000000b
b000003300000000000000000000000000000000000000000000000000000000000000000000000000000000000000000000000b
b000003300000000000000000000000000000000000000000000000000000000000000000000000000000000000000000000000b
b000003300000000000000000000000000000000000000000000000000000000000000000000000000000000000000000000000b
b000003300000000000000000000000000000000000000000000000000000000000000000000000000000000000000000000000b
b000u03300000000000000000000000000000000000000000000000000000000000000000000000000000000000000000000000b
b000003300000000000000000000000000000000000000000000000000000000000000000000000000000000000000000000000b
b000003300000000000000000000000000000000000000000000000000000000000000000000000000000000000000000000000b
b000003300000000000000000000000000000000000000000000000000000000000000000000000000000000000000000000000b
b000003300000000000000000000000000000000000000000000000000000000000000000000000000000000000060000000007b
b111113311111111111111111111111111111111111111111111111111111111111111111111111111111111111111111111111b
b222223322222222222222222222222222222222222222222222222222222222222222222222222222222222222222222222222b
bm333333333333333333333m333333333333333333333m33333333333333333333333333333333333333m333333333333333333b
bm333333333333333333333m33333333333333333333333m3333333333333333333333333333333333333333333333333333333b
bm33333333333333333333333333333333333333333333333333333333333333333333333333333333333333333333333333333b
bm33333333333333333333333333333333333333333333333333333333333333333333333333333333333333333333333333333b
b333333333333333333333333333333333333333333333333333333333333333333333333333333333333333333333333333333b
b333333333333333333333333333333333333333333333333333333333333333333333333333333333333333333333333333333b
eeeeeeeeeeeeeeeeeeeeeeeeeeeeeeeeeeeeeeeeeeeeeeeeeee3333333333333333333333333333333333333333333333333333b