                4           4        4           4          4       4                 4        4                4
                            4                                           4         4       4          4
                     4                    4           4                     4                              4
3333333333333333333333333333333333333333333333333333333333333333333333333333333333333333333333333333333333333333333333
3300000000000000000000000000000000000000000000000000000000000000000000000000000000000000000000000000000000000000000003
3300000000000000000000000000000000000000000000000000000000000000000000000000000000000000000000000000000000000000000003
3300000000000000000000000000000000000000000000000000000000000000000000000000000000000000000000000000000000000000000003
3300000000000000000000000000000000000000000000000000000000000000000000000000000000000000000000000000000000000000000003
3300000000000000000000000050000000000000000000000000000000000000000000000000000050000000000000000000000000000000000003
3300000000000000000000000000000000000000000000000000000000000000000000000000000000000000000000000000000000000000000003
3300000000000000000000000000000000000000000000000000000000000000000000000000000000000000000000000000000000000000000003
3300000000000000000000000000000000000000000000000000000000000000000000000000000000000000000000000000000000000000000003
3300000000000000000111111100000000000000000000000005000000000000000000000000000000000000000000000000000500000000000003
3300000000000000000022222200000000000000000000000000000000000000000000000000000000000000000000000001111000000000000703
3300000000000000000000000300000000000000000000000000000000000000000000000000000000000000000000000002332000000000111113
3311111000000000000000000000000000000000000000000000000000000000000000111100000000000000000000000000330000000000000223
3300000000000000000000000000000000000005000000000000000000000000000000022220000000000000000000000000000000000000000033
3300000000000000000000000000000000000000000000000000000000000000000000033000000000000000000000000000000000000000000003
3300000000000000000000000000000000000000000000000000000000000000000000000000000000000000000000000000000000000000000003
3300000000000000000000000000000000000000000000000000000000000000000000000000000000000000000000000000000000000000000003
3300000000000000000000000000000000000000000000000000000000000000000000000000000000000000000000000000000000000600000003
3311111111111111111111111111111111111111111111111111111111111111111111111111111111111111111111111111111111111111111113
3322222222222222222222222222222222222222222222222222222222222222222222222222222222222222222222222222222222222222222223
3333333333333333333333333333333333333333333333333333333333333333333333333333333333333333333333333333333333333333333333
3333333333333333333333333333333333333333333333333333333333333333333333333333333333333333333333333333333333333333333333
3333333333333333333333333333333333333333333333333333333333333333333333333333333333333333333333333333333333333333333333
3333333333333333333333333333333333333333333333333333333333333333333333333333333333333333333333333333333333333333333333
3333333333333333333333333333333333333333333333333333333333333333333333333333333333333333333333333333333333333333333333
3333333333333333333333333333333333333333333333333333333333333333333333333333333333333333333333333333333333333333333333
eeeeeeeeeeeeeeeeeeeeeeeeeeeeeeeeeeeeeeeeeeeeeeeeeeeeeeeeeeeeeeeeeeeeeeeeeeeeeeeeeeeeeeeeeeeeeeeeeeeeeeeeeeeeeeeeeeeeee